1111111111
1P11100CE1
1011001111
10011000C1
1100111101
10C00000C1
1111111111